{
  "label": "stage50_after",
  "captured_at": "2026-03-23T21:51:11.646204+00:00",
  "user_count": 50,
  "user_ids": [
    9100000501,
    9100000502,
    9100000503,
    9100000504,
    9100000505,
    9100000506,
    9100000507,
    9100000508,
    9100000509,
    9100000510,
    9100000511,
    9100000512,
    9100000513,
    9100000514,
    9100000515,
    9100000516,
    9100000517,
    9100000518,
    9100000519,
    9100000520,
    9100000521,
    9100000522,
    9100000523,
    9100000524,
    9100000525,
    9100000526,
    9100000527,
    9100000528,
    9100000529,
    9100000530,
    9100000531,
    9100000532,
    9100000533,
    9100000534,
    9100000535,
    9100000536,
    9100000537,
    9100000538,
    9100000539,
    9100000540,
    9100000541,
    9100000542,
    9100000543,
    9100000544,
    9100000545,
    9100000546,
    9100000547,
    9100000548,
    9100000549,
    9100000550
  ],
  "translation_check_sessions": 29,
  "translation_check_items": 203,
  "skill_events_v2": 660,
  "skill_state_v2_dirty": 24
}